,Team,Week,Rec,Opp,Tm_Score,Opp_Score,1stD_off,TotYd_off,PassY_off,RushY_off,TO_off,1stD_def,TotYd_def,PassY_def,RushY_def,TO_def,Offense_exp,Defense_exp,Sp. Tms_exp
1,Bills,1,Jan-00,Los Angeles Rams,31,10,23,413,292,121,4,19,243,191,52,3,13.89,10.29,-3.96
2,Bills,2,Feb-00,Tennessee Titans,41,7,23,414,313,101,,12,187,107,80,4,17.69,18.01,1.55
3,Bills,3,1-Feb,Miami Dolphins,19,21,31,497,382,115,1,15,212,171,41,,15.88,-7.45,-4.86
4,Bills,4,1-Mar,Baltimore Ravens,23,20,22,326,201,125,2,22,296,134,162,2,2.1,2.66,-1.69
5,Bills,5,1-Apr,Pittsburgh Steelers,38,3,21,552,432,120,2,23,364,310,54,2,20.66,9.42,3.54
6,Bills,6,1-May,Kansas City Chiefs,24,20,26,443,318,125,1,23,387,319,68,2,11.13,-6.45,0.56
7,Bills,8,1-Jun,Green Bay Packers,27,17,20,369,216,153,2,21,398,190,208,1,12.79,-5.55,4.01
8,Bills,9,2-Jun,New York Jets,17,20,19,317,183,134,2,21,310,136,174,1,0.54,-7.64,2.11
9,Bills,10,3-Jun,Minnesota Vikings,30,33,29,486,311,175,4,24,481,334,147,2,1.45,-4.8,-0.39
10,Bills,11,3-Jul,Cleveland Browns,31,23,22,357,186,171,,27,396,316,80,1,6,-10.86,13.72
11,Bills,12,3-Aug,Detroit Lions,28,25,28,401,237,164,1,22,326,230,96,2,16.07,-12.71,-3.07
12,Bills,13,3-Sep,New England Patriots,24,10,22,355,223,132,1,14,242,182,60,,9.5,1.41,3.26
13,Dolphins,1,Jan-00,New England Patriots,20,7,18,307,242,65,,17,271,193,78,3,6.08,8.28,1.98
14,Dolphins,2,Feb-00,Baltimore Ravens,42,38,27,547,461,86,2,23,473,318,155,,32,-20.31,-7.09
15,Dolphins,3,Mar-00,Buffalo Bills,21,19,15,212,171,41,,31,497,382,115,1,7.45,-15.88,4.86
16,Dolphins,4,1-Mar,Cincinnati Bengals,15,27,20,378,293,85,2,16,371,304,67,,0.48,-9.11,-3.73
17,Dolphins,5,2-Mar,New York Jets,17,40,19,295,158,137,2,21,322,187,135,,-6.15,-11.86,-3.66
18,Dolphins,6,3-Mar,Minnesota Vikings,16,24,23,458,385,73,3,11,234,156,78,,-8.38,4.43,-4.75
19,Dolphins,7,3-Apr,Pittsburgh Steelers,16,10,17,372,261,111,,19,341,246,95,3,0.04,6.72,-2.49
20,Dolphins,8,3-May,Detroit Lions,31,27,27,476,369,107,1,22,393,311,82,,25.47,-19.14,-0.59
21,Dolphins,9,3-Jun,Chicago Bears,35,32,21,379,302,77,,23,368,116,252,,19.83,-17.18,2.01
22,Dolphins,10,3-Jul,Cleveland Browns,39,17,29,491,296,195,,20,297,185,112,1,28.5,1.04,-4.93
24,Dolphins,12,3-Aug,Houston Texans,30,15,25,339,273,66,1,14,210,174,36,3,-1.9,22.74,-3.97
31,Eagles,1,Jan-00,Detroit Lions,38,35,27,455,239,216,,23,386,205,181,1,21.15,-15.67,-0.78
32,Eagles,2,Feb-00,Minnesota Vikings,24,7,25,486,323,163,1,20,264,202,62,3,14.26,7.86,-7.37
33,Eagles,3,Mar-00,Washington Commanders,24,8,21,400,328,72,,20,240,153,87,1,9.65,18.29,-8.92
34,Eagles,4,Apr-00,Jacksonville Jaguars,29,21,25,401,191,210,1,13,219,148,71,4,-0.18,11.06,-1.97
35,Eagles,5,May-00,Arizona Cardinals,20,17,24,357,218,139,,23,363,239,124,1,10.63,-12.33,5.16
36,Eagles,6,Jun-00,Dallas Cowboys,26,17,22,268,132,136,,21,315,181,134,3,7.95,0.04,3.76
38,Eagles,8,Jul-00,Pittsburgh Steelers,35,13,20,401,290,111,,21,302,158,144,2,23.31,4.96,-2.01
39,Eagles,9,Aug-00,Houston Texans,29,17,24,360,217,143,1,20,303,135,168,2,17.84,-1.89,-2.38
40,Eagles,10,1-Aug,Washington Commanders,21,32,18,264,170,94,4,25,330,178,152,2,-1.89,-4.13,-5.98
41,Eagles,11,1-Sep,Indianapolis Colts,17,16,18,314,173,141,2,14,284,185,99,1,-3.73,9.33,-1.97
42,Eagles,12,1-Oct,Green Bay Packers,40,33,29,500,137,363,1,19,342,236,106,2,20.82,-11.56,0.51
49,Vikings,1,Jan-00,Green Bay Packers,23,7,19,395,269,126,,21,338,227,111,2,9.99,1.89,1.12
50,Vikings,2,1-Jan,Philadelphia Eagles,7,24,20,264,202,62,3,25,486,323,163,1,-7.86,-14.26,7.37
51,Vikings,3,1-Feb,Detroit Lions,28,24,30,373,250,123,1,23,416,277,139,1,11.58,-8.25,1.93
52,Vikings,4,1-Mar,New Orleans Saints,28,25,23,344,263,81,1,19,338,227,111,2,6.41,-7.36,2.69
53,Vikings,5,1-Apr,Chicago Bears,29,22,29,429,312,117,1,14,271,193,78,1,21.45,-1.82,-9.74
54,Vikings,6,1-May,Miami Dolphins,24,16,11,234,156,78,,23,458,385,73,3,-4.43,8.38,4.75
56,Vikings,8,1-Jun,Arizona Cardinals,34,26,25,381,208,173,1,25,375,297,78,3,10.22,-2.87,3.71
57,Vikings,9,1-Jul,Washington Commanders,20,17,17,301,245,56,1,18,263,126,137,1,-2.12,1.76,2.55
58,Vikings,10,1-Aug,Buffalo Bills,33,30,24,481,334,147,2,29,486,311,175,4,4.8,-1.45,0.39
59,Vikings,11,2-Aug,Dallas Cowboys,3,40,16,183,110,73,1,23,458,307,151,,-14.35,-24.31,0.94
60,Vikings,12,2-Sep,New England Patriots,33,26,23,358,301,57,1,17,409,364,45,,9.14,-11.53,7.59
67,Chiefs,1,Jan-00,Arizona Cardinals,44,21,33,488,360,128,1,18,282,179,103,,33.41,-2.29,-6.88
68,Chiefs,2,Feb-00,Los Angeles Chargers,27,24,15,319,226,93,,21,401,326,75,1,5.54,-4.12,3.72
69,Chiefs,3,1-Feb,Indianapolis Colts,17,20,20,315,257,58,2,19,259,177,82,1,1.78,7.1,-13.31
70,Chiefs,4,1-Mar,Tampa Bay Buccaneers,41,31,27,417,228,189,1,27,376,373,3,2,17.12,-14.15,5.33
71,Chiefs,5,1-Apr,Las Vegas Raiders,30,29,29,368,265,103,,18,378,223,155,,14.21,-11.65,0.35
72,Chiefs,6,2-Apr,Buffalo Bills,20,24,23,387,319,68,2,26,443,318,125,1,6.45,-11.13,-0.56
73,Chiefs,7,2-May,San Francisco 49ers,44,23,24,529,417,112,2,25,444,343,101,3,30.58,-3.59,-8.5
75,Chiefs,9,2-Jun,Tennessee Titans,20,17,29,499,422,77,1,9,229,57,172,,5.59,3.85,-5.59
76,Chiefs,10,2-Jul,Jacksonville Jaguars,27,17,26,486,331,155,3,17,315,240,75,,23.27,-3.86,-7.32
77,Chiefs,11,2-Aug,Los Angeles Chargers,30,27,23,485,322,163,1,22,365,250,115,2,19.64,-8.61,-2.61
78,Chiefs,12,2-Sep,Los Angeles Rams,26,10,29,437,320,117,2,13,198,82,116,2,13.96,9.01,-8.76
